1521618087.rlg327
                                                                                
                                                                                
                  ######                                        ......          
              .......  #                                      ##......          
              .......  ####                                  ## ......          
              .......     ################################....###########       
                    #########..........                   ....      .........   
                             ..........                   #         .........   
                             ..........                   #         .........   
                             ..........                  .....      .........   
                             ..........                  .....                  
                             ..........                  .....                  
                             ..........                  .....                  
                             ..........###               .....                  
                                         #               .....                  
                                         #               .....                  
                                         #               #                      
                                         ###........##......                    
                                            ........  ......                    
                                                                                
                                                                                
1522914515.rlg327
                                                                                
                                                                                
                                    ################                            
                                    #              ##                           
                                    #               ##                          
                       .... ........#                ##########  .........      
                       ....#........#####       ..............#  .........      
                       .... ........#   ########..............#  .........      
                         #          #     #     ..............#  .........      
                         #          #     #     ..............###.........      
                         #          #     #     ..............   #              
                         #          #     #     ..............   #              
                         #          # .....     ..............####              
                   .......          # .....     ..............                  
                   .......########### .....                                     
                                      .....                                     
                                                                                
                                                                                
                                                                                
                                                                                
                                                                                
1523530501.rlg327
                                                                                
                                                                                
                                                                                
                                        #####.....                              
                                       ##    .....                              
          .....################        #     .....                              
          .....               ##      ##     .....   .....                      
          #                    #....###      .....###.....                      
          #                     ....         .....   .....                      
         ##                     ....         .....   .....                      
         #                      ....         .....   .....                      
         #                       #                   .....                      
         #                       #                   .....                      
         #                       #                   .....##############....    
         #                      ##                                      ....    
 .........                  ....#                                #######....    
 .........##                ....                                 #      ....    
 ......... ##               ....                                 #      ....    
            ##                                                   #      ....    
             #####################################################              
                                                                                
1524171099.rlg327
                                                                                
                                                             ......             
       .....                                                 ......             
       .....                              ###################......             
       .....                              #.....              #                 
       .....                              #.....              #                 
       .....########.....##################.....              #                 
          #         .....        #        #.....          #####                 
          #                      #        #.....          #                     
          #                      #        #.....         ##                     
          ##                     #        #.....        ##                      
           ####                  #        #.....#########                       
              ##                 ......   #                                     
               ##                ......####                                     
                #                   ####                                        
                #                 ###                                           
                ##               ##                                             
                 ###            ##                                              
                   ##           #                                               
                    #############                                               
                                                                                
1524787644.rlg327
                                                                                
                                 .....                                          
                                 .....                                          
                                  #                                             
                                  #                                             
                               ......                                           
                               ......   ....                                    
           ####################......###....##################                  
        ####                   ......   ....                 #......            
        #      ....            ......###....                 #......            
        #      ....            ......     #      ........... #......            
        #      ....            ......     ......#........... #......            
        #      ....#############          ...... ........... #......            
    ........     #                        ...... ...........##......            
    ........     #                        ......                                
    ........     #                                                              
    ........######                                                              
                                                                                
                                                                                
                                                                                
                                                                                
1525363666.rlg327
                                                                                
     .........        #######....#############################                  
     .........       ##      ....#                           ##                 
     .........       #       ....#                            ##                
     .........       #       ....##                            #                
     .........       #     #########                           #                
     .........##############       ##                     .....#                
     .........##  .......           #                     .....#                
               ###.......           ###                 ##.....#                
                  .......             .....##############                       
                  .......             .....                                     
                  .......                                                       
                                                                                
                                                                                
                                                                                
                                                                                
                                                                                
                                                                                
                                                                                
                                                                                
                                                                                
1525972216.rlg327
                                                                                
                                                                                
                                  ......                                        
                                  ......                                        
                                  ......#######....                             
                                  ......       ....              .....          
                                    #          ....              .....          
                                    #          ....              .....          
                                   ##          ....              .....          
                                   #           ....   .....      .....###....   
                                   #           ....   .....######.....###....   
 ....                         ..........       ....   .....######.....   ....   
 ....#..........##############..........          #   # ####     .....   ....   
 .... ..........              ..........      .......####                ....   
 ##########################   ..........      .......###                 ....   
                          ##  ..........      .......#                   ....   
                           ## ..........      .......#                   ....   
                            ##..........      .......#                          
                             #..........      .......#                          
                             #########################                          
                                                                                
1526652288.rlg327
                                                                                
                                                                                
                                                                                
                                                                                
                                                                                
                          ##########                                            
                        ###        .........                                    
                       ##          .........#.....#....################         
                      ##                     ..... ....               #         
                    ###                                               ##        
                    #                                                  ##       
     ####################                                               #       
     #             ##   ##                                              #       
    .....      .....     ##                                             #       
    .....     #.....      #                                     ##.....##       
    .....   ###    #      #######                               # .....         
        #####      #            ##                              # .....         
                   ####......    ##                             #               
                       ......     #                             #               
                                  ###############################               
                                                                                
1527308739.rlg327
                                                                                
                                                                                
                                                                                
                                       ....                                     
                             ......... ....                                     
              ........       .........#....                                     
              ........       .........                                          
            ##........#######.........                                          
            #                .........                                          
       ....##                .........                                          
       ....                  .........                                          
       ....#########         .........                                          
       ....        ###################                                          
       ....                         #...........                                
       ....                         #...........                                
       ....                         #...........###                             
       ....                         #######       ##                            
                                          ##       ###           ....           
                                           ##        ############....           
                                            ######################              
                                                                                
1527997509.rlg327
                                                                                
                                                                       .......  
                                                                       .......  
                                                                       .......  
                                                                       .......  
                                                                       .......  
                                                                       .......  
               .......                                                 .......  
               .......                              ###################.......  
                  #  #                             ##                 ##        
                  #  ##               ##############                  #         
       ################################....                           #         
       #          #    ##        ######....                           #         
       ............     ..........        #                      ......         
       ............     ..........        #                      ......         
       ............     ..........        #                      ......         
       ............     ..........        #######################......         
                        ..........                                              
                        ..........                                              
                                                                                
                                                                                
